"filename", "language", "JSON", "Python", "Markdown", "comment", "blank", "total"
"c:\Users\**replaced ALIAS using filter-repo**\Desktop\github\yshttl\README.md", "Markdown", 0, 0, 110, 0, 19, 129
"c:\Users\**replaced ALIAS using filter-repo**\Desktop\github\yshttl\archive\main.py", "Python", 0, 461, 0, 101, 127, 689
"c:\Users\**replaced ALIAS using filter-repo**\Desktop\github\yshttl\credentials.json", "JSON", 1, 0, 0, 0, 0, 1
"c:\Users\**replaced ALIAS using filter-repo**\Desktop\github\yshttl\program\auth_master.py", "Python", 0, 391, 0, 41, 64, 496
"c:\Users\**replaced ALIAS using filter-repo**\Desktop\github\yshttl\program\config_multiuser.json", "JSON", 21, 0, 0, 0, 0, 21
"c:\Users\**replaced ALIAS using filter-repo**\Desktop\github\yshttl\program\email_interface.py", "Python", 0, 137, 0, 26, 43, 206
"c:\Users\**replaced ALIAS using filter-repo**\Desktop\github\yshttl\program\email_query_storage.json", "JSON", 0, 0, 0, 0, 1, 1
"c:\Users\**replaced ALIAS using filter-repo**\Desktop\github\yshttl\program\schedule_multiuser.json", "JSON", 86, 0, 0, 0, 0, 86
"c:\Users\**replaced ALIAS using filter-repo**\Desktop\github\yshttl\program\server_interface.py", "Python", 0, 555, 0, 144, 83, 782
"c:\Users\**replaced ALIAS using filter-repo**\Desktop\github\yshttl\program\table_gen.py", "Python", 0, 148, 0, 18, 30, 196
"c:\Users\**replaced ALIAS using filter-repo**\Desktop\github\yshttl\program\yshttl.py", "Python", 0, 1088, 0, 270, 353, 1711
"c:\Users\**replaced ALIAS using filter-repo**\Desktop\github\yshttl\python\string_compare.py", "Python", 0, 5, 0, 0, 3, 8
"c:\Users\**replaced ALIAS using filter-repo**\Desktop\github\yshttl\python\test.py", "Python", 0, 6, 0, 106, 35, 147
"c:\Users\**replaced ALIAS using filter-repo**\Desktop\github\yshttl\python\ys_portal_login.py", "Python", 0, 523, 0, 91, 97, 711
"c:\Users\**replaced ALIAS using filter-repo**\Desktop\github\yshttl\samples\message_template.py", "Python", 0, 81, 0, 0, 1, 82
"c:\Users\**replaced ALIAS using filter-repo**\Desktop\github\yshttl\token.json", "JSON", 1, 0, 0, 0, 0, 1
"c:\Users\**replaced ALIAS using filter-repo**\Desktop\github\yshttl\users_discontinued.json", "JSON", 7, 0, 0, 0, 0, 7
"Total", "-", 116, 3395, 110, 797, 856, 5274